abjat	abjad
da	ada
ad	ada
adek	adik
adpokat	advokat
afdol	afdal
ajk	ajak
ajakin	ajaki
ahlak	akhlak
aktip	aktif
aktifitas	aktivitas
ane	aku
aq	aku
aqu	aku
eke	aku
eyke	aku
gua	aku
gue	aku
ak	aku
q	aku
almt	alamat
allah	Allah
alm	almarhum
ambeyen	ambeien
ambulan	ambulans
amandemen	amendemen
amphibi	amfibi
amvun	ampun
ank	anak
alay	anak layangan
analisa	analisis
handal	andal
anggep	anggap
agp	anggap
anying	anjing
anjay 	anjing kamu alay
antene	antena
antri	antre
anugrah	anugerah
apaa	apa
apah	apa
pa	apa
ap	apa
apaya	apa ya
apayaa	apa ya
apakh	apakah
apain	apakan
apalgi	apalagi
aposeh	apasih
amsyong	apes
apotik	apotek
azas	asas
astronot	astronaut
asek	asyik
asik	asyik
asyek	asyik
asyekk	asyik
ato	atau
atw	atau
atheis	ateis
atlit	atlet
atmosfir	atmosfer
autis	autisme
awl	awal
babe	ayah
bokap	ayah
ayok	ayo
ayuk	ayo
ayukz	ayo
yo	ayo
yok	ayo
yukk	ayo
yukz	ayo
yuq	ayo
ayk	ayuk
adzan	azan
boker	bab
bacain	bacakan
bdan	badan
begimana	bagaimana
gimana	bagaimana
bgmn	bagaimana
bag	bagian
bg	bagian
bgian	bagian
ajib	bagus
cakep	bagus
bgs	bagus
bgus	bagus
bhs	bahasa
bhsa	bahasa
bhw	bahwa
ajib	baik
bju	baju
bkr	bakar
balan	balans
bales	balas
bls	balas
balesin	balaskan
balsem	balsam
bences	banci
bencong	banci
lekong	banci
bngt	banget
bgst	bangsat
bangunin	bangunkan
bantuin	bantu
banyakk	banyak
bnyak	banyak
bnyk	banyak
byk	banyak
banyakin	banyaki
bp	bapak
bpk	bapak
brg	barang
brng	barang
bru	baru
bsh	basah
batalyon	batalion
batre	baterai
baterei	baterai
batrenya	baterainya
bw	bawa
baper	bawa perasaan
bayangin	bayangkan
byr	bayar
bbrapa	beberapa
bbrp	beberapa
gini	begini
bgini	begini
g7	begitu
gitchu	begitu
bgt	begitu
bgtu	begitu
blkg	belakang
blkng	belakang
bli	beli
bliau	beliau
beliin	belikan
blom	belum
lom	belum
belom	belum
blm	belum
blum	belum
lum 	belum
bener	benar
bner	benar
benr	benar
bnar	benar
bnerz	benar
bnr	benar
bnda	benda
bntr	bentar
brandal	berandal
brp	berapa
brpa	berapa
brarti	berarti
brasa	berasa
beberes	beres-beres
berhrap	berharap
kopel	berpasangan
berfikir	berpikir
bsar	besar
bsr	besar
esok	besok
bsk	besok
bsok	besok
betoel	betul
bikinin	bikinkan
blg	bilang
biosfir	biosfer
bs	bisa
bsa	bisa
blangko	blanko
bodo	bodoh
boong	bohong
boongnya	bohongnya
bkng	bokong
bleh	boleh
blh	boleh
bolehin	bolehkan
bosen	bosan
bosenin	bosan
ngebosenin	bosan
bete	bosan total
bsn	bosen
btol	botol
brangkas	brankas
bwt	buat
buatin	buatkan
bubarin	bubarkan
budhe	bude
bukde	bude
budeg	budek
budjet	bujet
bukak	buka
bk	buka
bka	buka
bkn	bukan
bukanny	bukannya
blan	bulan
bln	bulan
bulet	bulat
bulutangkis	bulu tangkis
bis	bus
anjir	buset
butu	butuh
cabe	cabai
cacimaki	caci maki
cntik	cantik
cntk	cantik
capek	capai
cape	capek
cr	cara
cidera	cedera
clana	celana
cendikiawan	cendekiawan
cinderamata / cenderamata	cendera mata
cengkram	cengkeram
cengkeh	cengkih
cepet	cepat
cpt	cepat
ceramahin	ceramahkan
nyinyir	cerewet
critanya	ceritanya
cewe	cewek
cewee	cewek
ce	cewek
cew	cewek
cw	cewek
cewenya	ceweknya
cobain	coba
coklat	cokelat
cnth	contoh
co	contoh
cth	contoh
cowo	cowok
cbt	cubit
cuekin	cuek
ckp	cukup
cm	cuma
cmn	cuman
daptar	daftar
dftar	daftar
dulu	dahulu
dulunya	dahulunya
drpada	daipada
dlam	dalam
dlm	dalam
otewe	dalam perjalanan
dn	dan
dll	dan lain lain
dsb	dan sebagainya
dapet	dapat
dapetin	dapat
dpt	dapat
dr	dari
dri	dari
dprd	daripada
drpd	daripda
dateng	datang
dtg	datang
dtng	datang
datengnya	datangnya
debitor	debitur
deket	dekat
dket	dekat
dkat	dekat
dkt	dekat
dekrit	dekret
dg	dengan
dgn	dengan
dng	dengan
denger	dengar
dgr	dengar
dnger	dengar
dngr	dengar
dgrin	dengarkan
dngerin	dengarkan
dengernya	dengarnya
dpan	depan
dpn	depan
depo	depot
dermawand	dermawan
designnya	desainnya
detil	detail
defiasi	deviasi
otw	di jalan
doi	dia
diagnosa	diagnosis
diem	diam
diampunin	diampuni
dicengin	diangguri
anggurin	dianggurkan
diblkg	dibelakang
dibeliin	dibelikan
dibersihin	dibersihkan
dibolehinnya	dibolehkannya
dibuatin	dibuatkan
didengerin	didengarkan
digabungin	digabungkan
diapalin	dihapalkan
dihilangin	dihilangkan
dijadiin	dijadikan
dijulukin	dijuluki
dikantongin	dikantongkan
dikeatasin	dikeataskan
dikirimin	dikirimkan
dimaklumin	dimaklumkan
dimanaa	dimana
dimatiin	dimatikan
dimudain	dimudahkan
diolokin	dioloki
dinyinyirin	diomongi
diomongin	diomongi
dipake	dipakai
dipinjemin	dipinjami
digebug	dipukul
diputusin	diputusi
diracunin	diracuni
disbbkan	disebabkan
diselesein	diselesaikan
disimpen	disimpan
dsni	disini
diskotik	diskotek
destilasi	distilasi
ditambahin	ditambahkan
dollar	dolar
dosn	dosen
drainage	drainase
dramatisir	dramatisasi
dduk	duduk
dudukny	duduknya
dlu	dulu
duren	durian
dsn	dusun
efektip	efektif
extra	ekstra
ektrim	ekstrem
ekstrimis	ekstremis
ektstrovert	ekstrover
elit	elite
emg	emang
emng	emang
hembus	embus
ajib	enak
enag	enak
ntr	entar
nt	ente
esei	esai
faksimil	faksimile
pebruari	februari
pondasi	fondasi
formil	formal
photo	foto
photokopi	fotokopi
fotosintesa	fotosintesis
frase	frasa
frekwensi	frekuensi
gbungkn	gabungkan
ghaib	gaib
gpp	gak papa
gmpng	gampang
ggu	ganggu
gnggu	ganggu
gy	gaya
gd	gede
gde	gede
gladi	geladi
gilak	gila
gmn	gimana
gmna	gimana
gt	gitu
gtu	gitu
giji	gizi
greng	goreng
gria	griya
goa	gua
gubug	gubuk
gudek	gudeg
guwe	gue
gw	gue
gn	guna
abis	habis
hbis	habis
hbs	habis
hadist	hadis
apal	hafal
hapal	hafal
hapal	hafal
hapalin	hafalkan
hey	hai
heyy	hai
hoi	hai
hakekat	hakikat
amsyong	hancur
hp	handphone
anged	hangat
anget	hangat
doang	hanya
apus	hapus
hrp	harap
hrg	harga
hr	hari
hri	hari
hrs	harus
hrus	harus
hsil	hasil
hsl	hasil
hti	hati
titi	hati-hati
hbt	hebat
hektar	hektare
hirarki	hierarki
hipotesa	hipotesis
hbgn	hubungan
hbngn	hubungan
hub	hubungan
hrf	huruf
emak	ibu
ijasah	ijazah
ihlas	ikhlas
ngikut	ikut
himbau	imbau
indra	indera
influensa	influenza
infra merah	inframerah
inpus	infus
igtkn	ingatkan
pengen	ingin
pingin	ingin
ni	ini
insyaf	insaf
inteligen	intelijen
inten	intens
interprestasi	interpretasi
intrupsi	interupsi
hisap	isap
islam	Islam
islamiyah	islamiah
istighfar	istigfar
istirht	istirahat
isteri	istri
isteri	istri
intermezo	itermeso
ijin	izin
jd	jadi
jdi	jadi
jadual	jadwal
jagad	jagat
jakt	jakarta
jl	jalan
jlan	jalan
jln	jalan
jgan	jangan
jgn	jangan
jngn	jangan
jrg	jarang
jrng	jarang
jwb	jawab
jwbnya	jawabnya
jlek	jelek
jamaah	jemaah
jenasah	jenazah
jendral	jenderal
yudo	judo
jg	juga
jmt	jumat
jml	jumlah
jmlh	jumlah
yunior	junior
agan	juragan
gan	juragan
jubir	juru bicara
jur	jurusan
jursn	jurusan
justeru	justru
kaco	kacau
kdg	kadang
kdng	kadang
kga	kagak
kgk	kagak
kaedah	kaidah
klo	kalau
kl	kalau
klau	kalau
klw	kalau
x	kali
choy	kalian
coy	kalian
cuy	kalian
kmpung	kampung
elo	kamu
elu 	kamu
ente	kamu
lo	kamu
lu	kamu
km	kamu
kmu	kamu
qm	kamu
kangker	kanker
kpn	kapan
karna	karena
karna	karena
krn	karena
krna	karena
krny	karenanya
karir	karier
kharisma	karisma
kharisma	karisma
karisma	karismatik
kharismatik	karismatik
cian	kasihan
kasian	kasihan
kesian	kasihan
katalisa	katalisis
ktny	katanya
ktnya	katanya
kwn	kawan
ky	kayak
kyk	kayak
kykny	kayaknya
kcewa	kecewa
kcl	kecil
kadaluwarsa	kedaluwarsa
kedelei	kedelai
klakuan	kelakuan
klmpok	kelompok
kluarkn	keluarkan
kmana	kemana
kmren	kemaren
kmarin	kemarin
kmrn	kemarin
balikin	kembalian
kple	kembaran
kmnangan	kemenangan
napa	kenapa
knp	kenapa
npa	kenapa
kendor	kendur
kpolisian	kepolisian
krja	kerja
ksl	kesel
kzl	kesel
sni	kesini
ktawa	ketawa
ketidurn	ketiduran
kturunan	keturunan
khutbah	khotbah
krm	kirim
client	klien
keloter	kloter
koboy	koboi
komersil	komersial
komplek	kompleks
komplit	komplet
komfirmasi	konfirmasi
kongkrit	kongkret
konkrit	konkret
konsekwensi	konsekuensi
krea	korea
konsleting	korsleting
kosa kata	kosakata
buluk	kotor
kreatip	kreatif
kreatifitas	kreativitas
kwalitas	kualitas
kwarsa	kuarsa
kwitansi	kuitansi
kulyh	kuliah
kul	kuliah
kworum	kuorum
krg	kurang
krg 	kurang
krng	kurang
cungkring	kurus
bangsat	kutu busuk
lapal	lafal
lg	lagi
lgi	lagi
lgu	lagu
lk	laki
lgsg	langsung
lgsung	langsung
lt	lantai
laper	lapar
lpr	lapor
lbh	lebih
lbih	lebih
legalisir	legalisasi
lembab	lembap
lembiru	lempar ganti baru
lht	lihat
cepek	lima puluh ribu
warbyasa	luar biasa
lobang	lubang
lp	lupa
lpa	lupa
5f	maaf
maap	maaf
mav	maaf
mf	maaf
mcem	macam
mcm	macam
mhs	mahasiswa
mhsw	mahasiswa
maba	mahasiswa baru
mkn	makan
mkny	makanya
mksh	makasih
maks	maksimal
mks	maksimal
mksd	maksud
mksudku	maksudku
mlh	malah
mlm	malam
malming	malam minggu
mager	malas
males	malas
mls	malas
mlu	malu
mmpu	mampu
mn	mana
mna	mana
managemen	manajemen
manager	manajer
mangkok	mangkuk
mantera	mantra
mrh	marah
mz	mas
mslh	masalah
msh	masih
mesjid	masjid
msk	masuk
msuk	masuk
mo	mau
mw	mau
mlekat	melekat
mmang	memang
mmg	memang
bonyok	memar
ngebela	membela
betulin	membetulkan
mempengaruhi	memengaruhi
ngingetin	memngingatkan
mmpelajari	memperlajari
mnang	menang
nyari	mencari
mcerna	mencerna
menyolok	mencolok
deketin	mendekati
dengerin	mendengarkan
duain	menduakan
ngalah	mengalah
ngapa	mengapa
ngapain	mengapa
arahin	mengarahkan
mngena	mengena
mngrti	mengerti
mgnggu	mengganggu
ngikutin	mengikuti
mengkonsumsi	mengonsumsi
merubah	mengubah
mngusap	mengusap
ngibul	menipu
nggilani	menjijikan
mentri	menteri
mnrt	menurut
mnurut	menurut
mrk	merek
mreka	mereka
metoda	metode
milyar	miliar
mggu	minggu
mgu	minggu
mg	moga
onyet	monyet
motip	motif
mdh	mudah
mudh	mudah
bosenan	mudah bosan
muke	muka
mka	muka
mgk	mungkin
mgkn	mungkin
mngkn	mungkin
musyafir	musafir
nahas	naas
nahkoda	nakhoda
nnt	nanti
nnti	nanti
nti	nanti
np	napa
nafas	napas
nafas	napas
nasehat	nasihat
negatip	negatif
negri	negeri
nelp	nelpon
netto	neto
ngk	nggak
cingcong	ngomong
btw	ngomong-ngomong
nomer	nomor
nntn	nonton
notulen	notula
nopember	november
ny	nya
obyek	objek
obyektif	objektif
omset	omzet
org	orang
orng	orang
organisir	organisasi
orisinil	orisinal
pd	pada
pdhl	padahal
pg	pagi
faham	paham
faham	paham
pke	pakai
palm	palem
plg	paling
pnggil	panggil
paradok	paradoks
paramedi	paramedis
psg	pasang
psang	pasangan
psng	pasangan
pas photo	pasfoto
pasport	paspor
msti	pasti
pavilion	paviliun
pedes	pedas
cemen	penakut
penghianat	pengkhianat
pnting	penting
pnyanyi	penyanyi
piranti	peranti
prmpuan	perempuan
cabut	pergi
capcus	pergi
vermak	permak
prnah	pernah
prnh	pernah
fikir	pikir
fikir	pikir
produktip	produktif
produktifitas	produktivitas
prototif	prototipe
propinsi	provinsi
projek	proyek
pkl	pukul
pulng	pulang
pp	pulang pergi
plh	pulih
pls	pulsa
pnah	punah
pny	punya
pnya	punya
py	punya
pusng	pusing
putera	putra
puteri	putri
rangsel	ransel
rapih	rapi
rapot	rapor
rasionil	rasional
remaj	remaja
resistan	resistans
respon	respons
rematik	reumatik
rejeki	rezeki
rbu	ribu
resiko	risiko
rmh	rumah
amsyong	rusak
sdarilah	sadarilah
syah	sah
syahih	sahih
ajah	saja
aj	saja
sj	saja
seksama	saksama
slng	saling
sm	sama
sma	sama
sambel	sambal
smbil	sambil
smpe	sampai
smp	sampai
smpai	sampai
sono 	sana
bangeet	sangat
banget	sangat
bangett	sangat
bangit	sangat
buanget	sangat
bnget	sangat
sngt	sangat
snggup	sanggup
sangsi	sanksi
syaraf	saraf
sdr	saudara
sdri	saudari
saos	saus
aing	saya
gwa	saya
sy	saya
sya	saya
ayang	sayang
ayank	sayang
ayanq	sayang
bebep	sayang
cayaank	sayang
cayang	sayang
cayank	sayang
yanx	sayang
syg	sayang
sbab	sebab
sbb	sebab
sbg	sebagai
sbgn	sebagian
sbelah	sebelah
sblah	sebelah
sblm	sebelum
sbnrnya	sebenarnya
sbntr	sebentar
sbt	sebut
scr	secara
scra	secara
sdg	sedang
hiks	sedih
dikit	sedikit
sdkt	sedikit
skit	sedikit
sgl	segel
sgra	segera
sgt	segitu
sht	sehat
sekedar	sekadar
skli	sekali
skr	sekarang
skrg	sekarang
skrng	sekarang
skul	sekolah
sklh	sekolah
skolah	sekolah
sekertaris	sekretaris
slg	selagi
selaen	selain
celaloe	selalu
celalu	selalu
claloeh	selalu
clalu	selalu
sll	selalu
sllu	selalu
slu	selalu
slama	selama
clamanya	selamanya
met	selamat
slamat	selamat
slmt	selamat
slasa	selasa
slsa	selasa
slse	selesai
smkin	semakin
smlm	semalam
cemangat	semangat
cemingit	semangat
cemungut	semangat
cemungutt	semangat
smngt	semangat
smua	semau
smt	semester
smtr	semester
semi final	semifinal
smg	semogo
sempet	sempat
smpt	sempet
smw	semua
seneng	senang
snang	senang
sneng	senang
sng	senang
sndri	sendiri
snen	senin
snin	senin
hee	senyum
hehe	senyum
hehehe	senyum
xixixi	senyum
snyum	senyum
sprt	seperti
sprti	seperti
spt	seperti
spti	seperti
seprei	seprai
ceban	sepuluh ribu
se7	setuju
stuju	setuju
asem	sialan
ciank	siang
ciapa	siapa
cp	siapa
syp	siapa
sp	siapa
spa	siapa
sbuk	sibuk
nyimak	simak
cini	sini
sintesa	sintesis
circus	sirkus
sistim	sistem
sistimatis	sistematis
sekala	skala
belago	songong
belagu	songong
standarisasi	standardisasi
badmood	suasana hati buruk
subyek	subjek
dah 	sudah
uda	sudah
udh	sudah
sdh	sudah
demen	suka
naksir	suka
sumpe	sumpah
beneran	sungguhan
spy	supaya
surt	surat
survey	survei
ssh	susah
sush	susah
sutera	sutra
sahid	syahid
sukur	syukur
tbh	tabah
td	tadi
tdi	tadi
tapsiran	tafsiran
thn	tahun
nampak	tampak
tgn	tangan
tgl	tanggal
tnp	tanpa
nanya	tanya
tny	tanya
tnya	tanya
tp	tapi
tw	tau
haha	tawa
hahaha	tawa
lol	tawa
wkwk	tawa
wkwkwk	tawa
tgas	tegas
tehnik	teknik
tehnisi	teknisi
tehnologi	teknologi
tauladan	teladan
toladan	teladan
tauladan	teladan
tlah	telah
nelpon	telefon
telpon	telepon
tlp	telepon
tmn	teman
tmpt	tempat
tgh	tengah
tntang	tentang
ttg	tentang
tentram	tenteram
teoritis	teoretis
trampil	terampil
terbru	terburu
trdengar	terdengar
makacih	terima kasih
makasi	terima kasih
makasih	terima kasih
thx	terima kasih
trims	terima kasih
terimakasih	terima kasih
trpaksa	terpaksa
cius	terus
trs	terus
trus	terus
thesis	tesis
ttp	tetapi
engga'	tidak
g	tidak
ga	tidak
gak	tidak
gk	tidak
ndak	tidak
ngak	tidak
ngga	tidak
nggak	tidak
tdk	tidak
tidk	tidak
gaada	tidak ada
gapapa	tidak apa-apa
gaenak	tidak enak
emoh	tidak mau
bobo	tidur
tdr	tidur
boboin	tidurkan
team	tim
tinggl	tinggal
tnggl	tinggal
taubat	tobat
tlg	tolong
tlng	tolong
tradisionil	tradisional
transport	transpor
triplek	tripleks
tropi	trofi
tgs	tugas
tugs	tugas
7an	tujuan
tt	tuker tambah
nulis	tulis
nunggu	tunggu
tggu	tunggu
duit	uang
katrok	udik
ulng	ulang
univ	universita
tuk	untuk
utk	untuk
utng	untung
urgent	urgen
urin	urine
ngurus	urus
ngurusin	urus
ust	ustadz
ustad	ustaz
hutang	utang
varitas	varietas
aduh	waduh
walo	walau
walopun	walaupun
wlpn	walaupun
walikota	wali kota
wnt	wanita
wrn	warna
wrna	warna
wasap	whatsapp
wirausaha	wira usaha
wudhu	wudu
yaa	ya
yap	ya
yha	ya
yoi	ya
yup	ya
yups	ya
y	ya
yg	yang
yng	yang
yaudah	yasudah
yutub	youtube
yutup	youtube
judikatif	yudikatif
judisial	yudisial
jurisdiksi	yurisdiksi
jaman	zaman
zam-zam	zamzam
jinah	zina
zone	zona
kak 	kakak
ngakak	ketawa